-212
-182
59
80
0000000000000000000000000000000
0000000000000000000000000000000
0000000000000000000000000000000
0000000000000000000000000000000
0000000000000000000000000000000
0000000000000000000000000000000
0000000000000111110000000000000
0000000000000111110000000000000
0000001000000111110000000000000
0000011100000111110000000000000
0000000000000111110000000000000
0000000000000000000000000000000
0000000000000000000000000000000
0000000000000000000000011100000
0000000000000000000000011100000
0000000000000000000000011100000
0000000000000000000000000000000
0000000000000000000000000000000
0000000000000000000000000000000
0000000000000000000000000000000
0000000000000000000000000000000
0000000000000000000000000000000
