-218
-183
62
81
111111000000000000000000000000000001
111100000000000000000000000000000001
111000000000000000000000000000000000
110000000000000000000000000000000000
100000000000000000000000000000000000
100000000000110000000000000000000000
000000000000111100000000000000000000
000000000000111100000000000000000000
000000000000111000000000000000000000
000000000000000000000001111100000000
000000000000000000000001111100000000
100000000000000000011111111100000000
100000000000000011111111111100000000
110000000000011111111111111100000000
110000000000011111111111100000000000
111100000000000000000000000000000001
111110000000000000000000000000000001
111110000000000000000000000000000001
111110000000000000000000000000000111
111111100000000000000000000000111111
