-214
-158
59
85
111111111100000000111111111111111111100000000111111111111
111111110000000000011111111111100000000000000001111111111
111111110000000000001111111111000000000000000000111111111
111111110000000000000111111110000000000000000000011111111
111111000000000000000111111110000000000000000000011111111
111110000000000000000111111110001111000000000000001111111
111100000000000000000111111110001001000000000000001111111
111000001000000110000111111110001001000000000000000111111
110000111000000110000011111110000000000000000000000111111
110000000000000110000011111110000000000000000000000111111
100000000000000110000011111100000000000000000000000111111
100000000000000110000011111100000000000000000000000111111
000000000110000110000001111100000000000000000110000001111
000000001110000000000001111100000000000000000010000000111
000000011110000000000000111100000000000000000000000000111
000001111110000000000000011100010000001000000000000000011
100011111110000000000000000000010000001100000000000000011
100011111110000000000000000000110000011100000000000000001
111111111110000000000000000001100000011100000000001110001
111111111110000000111000000000000000111100000000000000000
111111111110000111111000000000000000111110000000000000000
111111111110000000000000000000000011111111000000011111000
111111111111000000000000000000000111111111110000000000001
111111111111000000000000000000011111111111111100000000011
111111111111110000000000000011111111111111111110011111111
111111111111111000000000111111111111111111111111111111111
111111111111111110000111111111111111111111111111111111111
